2024-07-07
#################
#E..#......M....#
###.#.#######.###
#.#.#C#....B#...#
#.#.#.#.###.###.#
#...#...#.#C#...#
#.#######.#.#.#.#
#M..#.#...#.#.#.#
###.#.#.#.#.#.#.#
#T..#...#..H#.#.#
#.###########.#.#
#.#....T.B#...#.#
#.#.#####.#.###.#
#.#..H#...#M#.#.#
#.###.#.###.#.#.#
#.....#.....#T.S#
#################