2024-07-05
#################
#E#.#T....#.....#
#.#.#.#.###.#.###
#A#..H#....T#...#
#A#.#####.#####.#
#A#.#M..#M..#...#
#A###A#.#.###.#.#
#...#.#.#.#...#.#
###A#.#.###.###.#
#.#..T#.#.A.#M#.#
#.#####.#.###.#.#
#....T#.A.#C..#.#
#.#########.#.#.#
#.#...#.....#M#.#
#.#.#.#.#####.#.#
#...#..H...C#M.S#
#################