2024-07-05
#################
#E..#....M#.....#
###.#.###.#.###.#
#...#...#....T#.#
#.#####.#######.#
#..B#C....#...#.#
###.#######.#.#.#
#M..#......C#.#.#
#.###.#######.#.#
#.#...#.......#H#
#.###.#.#######.#
#.....#.#.......#
#######.###.#.#.#
#C....#...#.#C#.#
#.###.###.###.#.#
#M.C#T........#S#
#################