2024-07-05
#################
#E#.#T....#.....#
#.#.#.#.###.#.###
#.#..H#....T#...#
#A#.#####.#####.#
#A#.#M..#M..#...#
#.###.#.#.###.#.#
#...#.#.#.#...#.#
###A#.#.###.###.#
#.#..T#.#.A.#M#.#
#.#####.#.###.#.#
#....T#.A.#C..#.#
#.#########.#.#.#
#.#...#.....#M#.#
#.#.#.#.#####.#.#
#...#..H...C#M.S#
#################