2024-07-05
#################
#E.......MA....C#
###############.#
#...#....C....#.#
#.###.###.###.#.#
#C#T.T#H#...#.#C#
#.#.###.###.###.#
#...#.....#.....#
#.###.###.#######
#.A.#...#.......#
###.#######.#.###
#..A#.....#.#...#
#.###.###.#####.#
#B..#.#...#.....#
###.#.#.###.###.#
#.....#C....#..S#
#################