2024-07-05
#################
#E#.........#T..#
#.#.###.###.#.#.#
#.#...#B#.....#.#
#.#####.#.#######
#.....#.#B#.....#
#####.#.###.###.#
#...#.#.....#...#
###.#.#.#####.###
#...#.#....B#...#
#.#.#.#####.###.#
#.#C#B..#H..#...#
#.#.###.#####.#.#
#.#...#C...C..#.#
#.#############.#
#..T...........S#
#################