2024-07-05
#####################
#E......#...#...#...#
#######.#.#.#.#.#.###
#M.H#T..#C#H#.#.#...#
#.###.###.#.#.#.###.#
#B..#.#...#.#.#.....#
#.#.#.#.###.#.#####.#
#.#M#.#.#...#.#.....#
#.#.#.#.###.#.###.###
#.#B#.#..B#.#...#...#
###.#.###.#.###.#####
#...#..C..#...#.....#
#.###########.#####.#
#.#.........#.....#T#
#.#.#.#.#########.#.#
#...#.#.#.....#...#H#
#.###.###.###.#.###.#
#.#.#..C#..H#B..#T..#
#.#.###.###.#######.#
#.....#............S#
#####################