2024-07-04
#####################
#E..#..C..#..H#B....#
###.#.#####.#.#.#.###
#...#......H#B..#...#
#.###.###########.#.#
#...#M#H#H.....B#.#C#
###.#.#.#.#####.#.#.#
#...#...#.#...#H#.#.#
#.#######.#.#.#.###.#
#.#.......#.#C...H#.#
#.###.###########.#.#
#..B#..C......#..T#.#
###.#########.#.###.#
#M#..T#..H...T#...#.#
#.###.#.#########.#.#
#T..#B#B...M#...#...#
#.#.#.#.###.#.#####.#
#.#.#.#...#.#.#...#.#
#.#.#.#####.#.#.#.#.#
#.#..M......#...#..S#
#####################